NO images/wall_no.xpm
SO images/wall_so.xpm
WE images/wall_we.xpm
EA images/wall_ea.xpm

F 220,100,0
C 25,25,112

1111111111111
1000000000001
1011111111101
1010000000101
1010N00000101
1010000000101
1011111111101
1000000000001
1111111111111
