NO images/wall_no.xpm
SO images/wall_so.xpm
WE images/wall_we.xpm
EA images/wall_ea.xpm

F 100,160,80
C 30,30,120

11111111111111111
10000000000000001
10111111110111101
100000N0000010001
10111111110111101
10000000000000001
11111111111111111
